11111111111
1P0000C0001
10011111001
10C11111001
10000C000E1
11111111111